00000000000000000000
11111101111111111110
11000101111100011110
11010000001101011110
11000111101100011110
11111111101110111110
00000000000000000000
01110111111111111111
01110000000011111111
01111111111001111111
01111111111100111111
01111111111110111111
00000000000000000000
